BD1553B917
C52D16C683
BFAFAFFFAA
AFEF857FEA
AFFFAFFF96
857FAFD503
853FAFFFEA
C3C5695552
96D552957A
C55556C556
